NO      ./textures/wall_north.xpm   
SO ./textures/wall_south.xpm
EA ./textures/wall_east.xpm
WE ./textures/wall_west.xpm
F 50,50,50

C 70,130,180





        111111111111111111111111
        1000000001100000000000001
        110110000111000000000011
        100100000000000000000001
111111111011000001110000000000001
100000000011000001110111111111111
111110111111111011100000010001
111110111111111011101010010001
11000000110101011100000010001
100000000000000N000000010001
10000000000000001101010010001
100000111010101111111111000111
11111110111010111       11111
111111111111111111111111111



