111111
100101
101001
110011
111111