111111
100101
1010E1
11E011
111111