NO ./textures/wall_north.xpm
SO ./textures/wall_south.xpm
EA ./textures/wall_east.xpm
WE ./textures/wall_west.xpm
F 220,100,0
C 225,30,0

111111111111

100001000001
10001 1000001
100001000001
10001N000001
100000000001
100000000001
111111111111
