NO ./textures/wall_north.xpm
SO ./textures/wall_south.xpm
EA ./textures/wall_east.xpm
WE ./textures/wall_west.xpm
F 169    ,      169      ,      169
C 0,191,252

              

        111111111111111111111111
        1000000001100000000000001
        11011000011100000000001
        100100000000000000000001
111111111011000001110000000000001
100000000011000001110111111111111
111110111111111011100000010001
111110111111111011101010010001
11000000110101001100000010001
1000000000000E11100000010001
10000000000000001101010010001
100000111010101111101111000111
111111101110101 101111010001
111111111111111111111111111