NO ./wall_north.xpm
SO ./wall_south.xpm
EA ./wall_east.xpm
WE ./wall_west.xpm

C	1,102,204
F	0,102,51

        111111111111111111111111
        100000000110000000000001
        110110000111000000000001
        100100000000000000000001
11111111101100000111000000000001
100000000011000001110111111111111
111110111111111011100000010001
111110111111111011101010010001
11000000110101001100000010001
1000000000000N11100000010001
10000000000000001101010010001
100000111010101111101111000111
111111101110101 101111010001
111111111111111111111111111